1111111111111111111111111111111111
0000100100000001000000000000
0000100100020001000200000100
0000020100010001000000000102
0000000000010000000001000000
0000000000010000000010000000
0000100100000000000010201000
0000100100000201000000001001
111111111111111111111111111111111