1111111111111111111111111111111111
100100000001000000000000
100100000001000000000100
000100010001000000000100
000000010000000001000000
000000010000000010000000
100100000000000010001000
100100000001000000001001
111111111111111111111111111111111