1111111111111111111111111111111111
100100000001000000000000
100100020001000200000100
020100010001000000000102
000000010000000001000000
000000010000000010000000
100100000000000010201000
100100000201000000001001
111111111111111111111111111111111