1111111111111111111111111
0000000100010001000000003
0002000100010001000200003
0000000000010000000000003
0001000200010002000100003
0001000000000000000100003
0001000100020001000100003
0001000100000001000100003
1111111111111111111111111