1111111111111111111111111111111111
00000000100100000001000000000000
00000000100100020001000200000100
00000000020100010001000000000102
00000000000000010000000001000000
00000000000000010000000010000000
00000000100100000000000010201000
00000000100100000201000000001001
111111111111111111111111111111111