1111111111111111111111111111111111
0000000000100000000000000000000003
0000000000100000000000000000000003
0000011100100000000000000000000003
0000011100010000000000000000000003
0000011100000000000000000000000003
0000011100000100000000000000000003
0000011100000010000000000000000003
1111111111111111111111111111111111