1111111111111111111111111111111111
0000000000100000001000000010000003
0000000000100000001000010010000003
0000011100100000001000100001000003
0000011100010000010001000000100003
0000011100000020000010000000010003
0000011100000101000010000000020003
0000011100000010000010000000000003
1111111111111111111111111111111111