1111111111111111111111111111111111
0000000100010001000000010001000103
0002000100010001000200010001000103
0000000000010000000000000001000003
0001000200010002000100020001000203
0001000000000000000100000000000003
0001000100020001000100010002000103
0001000100000001000100010000000103
1111111111111111111111111111111111
