1111111111111111111111111111111111
0001000100010000000100010000000003
0001000100010000000100010000200003
0000000100020000000000010000100003
0002000000000001000200010000100003
0000000200010000000000000000100003
0001000100010002000100000000100003
0001000100010000000100020000100003
1111111111111111111111111111111111