1111111111111111111111111111111111
0000000000000000000000000000000003
0001000010001000000010000101000003
0000000020000010000000020000000103
0001000000000000000000000000002003
0000000100000020000000100000010003
0000000100000000000100000000010003
0000000000000010000000000000000003
1111111111111111111111111111111111