1111111111111111111111111111111111
0000000100000000100000000000000003
0000000100000000100000000100000003
0000000100000000100000000100000003
0000000000000000100000000100000003
0000000100000000100000000100000003
0000000100000000100000000100000003
0000000100000000000000000100000003
1111111111111111111111111111111111