2222222111111111111111111111111111
1222222100000012222222210000001223
1122221000200011122222102000001223
0011110001111222011111020111100113
0000002011212110220010201121100003
0000001112121211110220011212100003
1111112121212121211111112121211113
1112121212121212121212121212121213
1111111111111111111111111111111111