100100100001000000000000
000100000001000000000000
000000000001000000011001
100000100000000010001000
100100100000000010000000