111111111111111111111111000000000
000100010001000000010000
000100010001000000010000
000000010002000000000000
000200000000000100020000
000000020001000000000000
000100010001000000010000
000100010001000200010000
111111111111111111111111000000000