111111111111111111111111111111111
000100010001000000010001000000000
000100010001000000010001000020000
000000010002000000000001000010000
000200000000000100020001000010000
000000020001000000000000000010000
000100010001000200010000000010000
000100010001000000010002000010000
111111111111111111111111111111111