1111111111111111111111111111111111
0000000100010001000000010000000003
0002000100010001000200010000000003
0000000100010001000000010000000003
0001000100010001000100010000000003
0000000111110000000100011111111113
0000000000020000000000000000020003
0000000000000000000000020000000003
1111111111111111111111111111111111