1111111111111111111111111111111111
00100100000001000000000000
00100100020001000200000100
00020100010001000000000102
00000000010000000001000000
00000000010000000010000000
00100100000000000010201000
00100100000201000000001001
111111111111111111111111111111111