1111111111111111111111111111111111
0000200001000000000001100000000103
0000000010100002000010010000001003
0000000100010000000100001000010003
0000012000000000000000200000200003
0000100000000010000100001000010003
0001001010101001000010010000001003
0010000000000000100001100000000103
1111111111111111111111111111111111