111111111111111111111111111111111
000000010001000100000001000000000
000200010001000100020001000000000
000000010001000100000001000000000
000100010001000100010001000000000
000000011111000000010001111111111
000000000002000000000000000002000
000000000000000000000002000000000
111111111111111111111111111111111