1111111111111111111111111111111111
0000000010000100001000001000000003
0000100000000100001000002000000003
0000000010000100001000001000100003
0000100020000000002000001000100003
0000200010000000001000001000100003
0000000000000100001000001000000003
0000100010000100001000001000000203
1111111111111111111111111111111111