11111111111111111111111110
00000001000100010000000030
00020001000100010002000030
00000000000100000000000030
00010002000100020001000030
00010000000000000001000030
00010001000200010001000030
00010001000000010001000030
11111111111111111111111110