1111111111111111111111111111111111
0000000100000000100000000200000003
0000000100000000100000000100000003
0000000100200000100000000100000003
0000000200000000100000000100000003
0000000100000000100000000100000003
0000000100000000100000000100000003
0000000100000000200000000100000003
1111111111111111111111111111111111