1111111111111111111111111111111111
0000000000000000000200000000000003
0001000010000100000000000000000003
0000000000000000000100000111111113
0000100100200100000100000100000023
0000200000000000000100000100001003
0000000010010000000001000000001003
0000000000000000000001000000001003
1111111111111111111111111111111111