111111111111111111111111
000000010001000100000000
000200010001000100020000
000000000001000000000000
000100020001000200010000
000100000000000000010000
000100010002000100010000
000100010000000100010000
111111111111111111111111