1111111111111111111111111111111111
0000000000010000000100000001000103
0000000100010000000100000001000103
0001000100000001000100010000000103
0001000100000001000000000000000003
0001000000010000000000010000000003
0000000000010001000000000001000003
0000000000010000000100000001000103
1111111111111111111111111111111111
