1111111111111111111111111111111111
0001000100010001000100020002000103
0001000100000001000000000000000003
0000000100000001000000010001000003
0000000000010001000100010001000103
0001000000010000000200000001000103
0001000100010000000100010001000103
0001000100020001000100000001000203
1111111111111111111111111111111111
