1111111111111111111111111111111111
0002000100000002000200010001000103
0001000100020000000100010001000103
0001000000010001000100000001000103
0001000000010001000100000000000103
0000000000010000000000010000000003
0000000100000001000000010001000003
0001000100000000000100010001000103
1111111111111111111111111111111111
