1111111111111111111111111111111111
0001000100000001000000000001000103
0001000100000000000100000000000003
0000000000010000000100010000000003
0000000000020001000200020001000103
0000000100010001000100010001000203
0001000100000001000000000001000103
0001000100000001000000000002000103
1111111111111111111111111111111111
