1111111111111111111111111111111111
0002000100010001000000010001000103
0001000100010001000000000000000103
0001000100010001000100010000000103
0001000100000000000200000001000103
0000000000000000000100000001000103
0000000000010001000000010001000003
0001000100010001000000010002000003
1111111111111111111111111111111111
