1111111111111111111111111111111111
0002000200000001000100000001000003
0000000100000000000100000001000003
0001000100010000000100010001000103
0001000100020001000100020000000203
0001000000010001000000010000000103
0001000000000001000000000001000003
0001000100000001000100000001000003
1111111111111111111111111111111111
