1111111111111111111111111111111111
0000000000000000000000000001000103
0000000100010000000000010001000103
0001000100010001000000010000000103
0001000100000001000100000000000103
0001000000010001000100010000000103
0001000000000000000100000001000003
0001000000000000000000000001000003
1111111111111111111111111111111111
