1111111111111111111111111111111111
0002000000010001000200020001000103
0000000200010001000100000001000003
0001000100010000000100010000000003
0001000100000000000100010000000103
0001000100000001000000000000000103
0001000000010001000000010001000103
0001000000010001000100000001000103
1111111111111111111111111111111111
