1111111111111111111111111111111111
0001000000010000000000000001000103
0000000000000000000000000001000103
0000000100010001000100010001000003
0000000100000001000100010000000003
0001000100000001000100010000000003
0001000000010000000100010001000103
0001000000010000000100010001000103
1111111111111111111111111111111111
