1111111111111111111111111111111111
0001000000010001000000000001000103
0000000000010001000000000001000103
0000000100000001000000010000000103
0000000000000000000100010000000003
0001000100000000000100010000000003
0001000000010001000100010001000103
0001000000010001000100010001000103
1111111111111111111111111111111111
