1111111111111111111111111111111111
0001000100000000000100000001000003
0001000100010001000000010000000103
0000000100010001000000010000000103
0000000000000000000000000000000003
0000000000010001000100010001000103
0001000000000000000100000001000003
0001000100000000000100000001000003
1111111111111111111111111111111111
