1111111111111111111111111111111111
0000000100000001000100010000000103
0000000100000001000100010000000103
0001000000010000000100000001000103
0001000000010000000000000001000103
0001000000010000000000010000000103
0000000100010001000000010001000003
0000000100010001000100010000000003
1111111111111111111111111111111111
