1111111111111111111111111111111111
0002000100010001000100010001000203
0000000000010000000100010001000103
0001000000000000000000000000000103
0001000100000001000000000000000103
0000000100000002000000000001000003
0001000100010001000100010001000003
0000000100010001000100010001000103
1111111111111111111111111111111111
