1111111111111111111111111111111111
0000000100000000000100020000000203
0001000000010002000000010001000103
0001000100010001000000010001000103
0002000000020001000100010002000103
0001000000010001000100000001000003
0000000100000000000100000000000003
0000000100000000000200010000000103
1111111111111111111111111111111111
