1111111111111111111111111111111111
0001000000010001000100000002000103
0001000200010001000100020000000103
0000000100010001000000010001000103
0000000100010000000000010001000003
0001000100010000000100010001000003
0001000000000001000100000001000103
0001000000000001000100000001000103
1111111111111111111111111111111111
