1111111111111111111111111111111111
0000000100000000000100010001000103
0000000000000000000100000001000003
0001000000010000000000010000000103
0000000000010001000000000000000003
0001000100010001000100000001000003
0000000100010001000100010001000103
0000000100010001000100010001000103
1111111111111111111111111111111111
