1111111111111111111111111111111111
0001000000000001000000010000000003
0001000100010001000000010000000003
0001000100010001000100000001000103
0000000000010001000000000001000103
0000000100000001000100010001000103
0000000000000000000000010001000003
0001000000000000000000010001000003
1111111111111111111111111111111111
