1111111111111111111111111111111111
0001000100020001000100010001000003
0001000000010000000000000000000103
0000000000010000000000000001000103
0000000100010001000100010000000203
0000000200000002000200010000000103
0001000100000001000100010001000003
0001000100010001000100020001000003
1111111111111111111111111111111111
