1111111111111111111111111111111111
0000000100000000000000010001000003
0000000000000000000100010001000103
0001000100000001000100010001000103
0001000000010001000100000000000103
0001000000010001000000000000000003
0000000100010000000000010000000003
0000000100000000000000010001000003
1111111111111111111111111111111111
